* 군기침

    - 일부러 내는 기침. (인기척을 낼 때)


* 군식구

    - "군"은 가외로 더한, 덧붙은

* 군살, 군말

    - "군"은 쓸데없는



* 붙으면 새말이 만들어 지는 거니까.... 원래 각각의 단어 의미보다는 조금 달라지게된다.

    ex) 잘되다          -       일이 좋게 이루어지다, 훌령하게 되다.

    ex) 잘생기다        -       hansome 

    ex) 잘입다          -       패셔니스타

    ex) 잘하다          -       skillful

    ex) 못하다          -       똥손


* 띄어 쓰면 두단어의 의미가 각각 살아나게 된다.

    ex) 잘 되다     -       말 그대로 잘~~~ 되는거임. 즉 자주 생기는거. 자주 발생하는 거.

    ex) 잘 생기다   -       자주 발생하다

    ex) 잘 입다     -       MOPP

    ex) 잘 하다     -       하는일을 잘 해.

    ex) 못 하다     -       아예 시작조차 하질 못하는 거.

        "못"은 부정부사




* 음운      -       음소, 운소



* 음소      -       자음, 모음


* 운소      -       장단, 강세, 억양, 성조....



* 자음 19개 



* 자음 제자의 원리

    1. 상형의 원리      -       ㄱ      ㄴ      ㅁ      ㅅ      ㅇ

    2. 가획의 원리      -       ㅋ      ㄷ ㅌ   ㅂ ㅍ   ㅈ ㅊ   ㅎ

    3. 병서의 원리      -       ㄲ ㄸ ㅃ ㅆ ㅉ                          <= 각각 음운 1개임

    4. 이체자           -       ㄹ



* 자음은 3중 체계로 되어있다.

    1. 예사소리(평음)   -       ㄱ  ㄷ  ㅂ  ㅅ  ㅈ  ㅎ

    2. 된소리(격음)     -       ㄲ  ㄸ  ㅃ  ㅆ  ㅉ

    3. 거센소리(격음)   -       ㅋ  ㅌ  ㅍ  ㅊ
        





















